AAAAAAAAAAAAAAAAAAAAAAAAAAAAAA
AAAAAAAAAAAAAAAAAAAAAAAAAAAAAA
AAAAAAAAAAAAAAAAAAAAAAAAAAAAAA
AAAAAAAAAAAAAAAAAAAAAAAAAAAAAA
AAAAAAAAAAAAAAAAAAAAAAAAAAAAAA
AAAAAAAAAAAAAAAAAAAAAAAAAAAAAS
AAAAAAAAAAAAAAAAAAAAAAAAAFFFFF
AAAAAAAAAAAAAAAAAAAAAAAAAAAAAA
AAAAAAAAAAAAAAAAAAAAAAFFAAAAAA
AAAAAAAFFAAFFAAFFAAFFAAAAAAAAA
AAAAAAAAAAAAAAAAAAAAAAAAAAAAAA
AAAAAAAAAAAAAAAAAAAAAAAAAAAAAA
AAAAAAABBBBBBBBBBBBBBBBAAAAAAA
ZAABBBBCCCCCCCCCCCCCCCCBBBBDDD
BBBCCCCCCCCCCCCCCCCCCCCCCCCDDD
CCCCCCCCCCCCCCCCCCCCCCCCCCCCCC
